1111111111111111111
1P010000C0100000001
10B100100010B01C001
1000001EB0000010001
1111111111111111111