11111111111111111111111111111111111111
10000000000000000000000000000000000C01
10E00000000001111111011111111111111101
100000000011111111C0011110001111111101
100000001111111PC00001110C001111111101
1000011111111C000000010B00001111111C01
1001111111C0000B0000000001111111100B01
10111111C00000000000000111111100000001
101111CCCCCCC0CCCCCC011111110000000101
10111111111111111111B11111110000011101
10111111111111111111011111110001111101
10111111111111111111011111111111111101
100C0B00000001111111000000000000000001
1000B0000B0C011111110000000C0000000001
100000B00B0C011111110000000B0000000001
100000000B0C011111110000000C0000000001
11111111111111111111111111111111111111