11111111111111111111111111111111
1P0100000010C0100000000000000001
100100000010001001000000000BC001
1B010000000000100111100001111111
10000000100B00100000100001000001
1000000010000C00B000100001000001
111111111001111111111000010BE001
100100000000000000000000010B0001
10010000111111110000000001011111
1C00000010000B0100001000B0000001
1111100011111C01000010000C000001
1C000000000000010000100000000001
11111111111111111111111111111111